NO texture/w.png
SO texture/s.png
WE texture/n.png
EA texture/e.png
F 0,0,0
C 0,0,0

1111111111
1000000001
1011111101
1010000101
1010110101
1000E0001
1111111111


